WRRRRRRRRRRW
WWRRRRRRRRWW
WRWRRRRRRWRW
WRRWRRRRWRRW
WRRRWRRWRRRW
WRRRRWWRRRRW
WRRRRRRRRRRW
WRRRRRRRRRRW
