WRWWWWWWWWRW
RRRRRRRRRRWR
WRWWWWWWWWRW
WRWWWWWWWWRW
WRWWWWWWWWRW
WRWWWWWWWWRW
RWRRRRRRRRRR
WRWWWWWWWWRW
